####################################################################################################
#                                                                                                  #
#              #                                                                                   #
#    ###########                                                                                   #
#              #  #  #                                                                        #    #
#    O       # #  #  #             #                                                     #    #    #
#   #        # #  #  #             #                                                     #    #    #
#   #        # #  #  #             #                                                     #    #    #
#   #        # #  #  #             #                                                     #    #    #
#   #        ##########            #                                                     #    #    #
#   #          #  #  #            ##                                                     #    #    #
#   #          #  #  #            ##          #################                      #   #    #    #
#   #          #  #  #            ##            #                 ############       #   #    #    #
#   #          #  #  #            ##            #                 #   #              #   #    #    #
#   #          #  #  #            ###           #                 #   #              #        #    #
#   #   #         #  #            ###           #                 #   #              #        #    #
#   #   #         #               ###           #                 #   #              #        #    #
#   #   #         #               ###           #                 #   #              #        #    #
#   #   #         #               ###                    ################        #   #        #    #
#   #   #         #               ###                        ############        #   #        #    #
#      ##         #               ###                             #   #          #   #        #    #
#      ##                         # #                             #   #          #   #        #    #
#      ## #                         #                             #   #          #   #             #
#      ## #                         #                             #   #          #   #             #
#      ## #          #              #                             #   #    #     #   #             #
#       # #          #              #                             #   #    #     #   #             #
#       # #          #              #                             #   #    #     #   #             #
#       # #          #              #                             #   #    #     #       #         #
#       # #          #              #             #               #   #    #     #       #         #
#       # #          #              #             #               #        ########      #         #
#       # #          #              #             #               #        #     #       #         #
#       # #                                       #                        #     #       #         #
#       # #  #                                    #                        #     #       #         #
#       # #  #                                    #                        #     #       #         #
#         #  #          #############     #####   #                        #     #       #         #
#      #  #  #                                    #                ###########   #       #         #
#      #  #  #                                    #                        #             #         #
#      #  #                                       ################         #             #         #
#      #  #         #                                                      #             #         #
#      #  #         #                                                      #             #         #
#      #            #                                                      #             #         #
#      #            #                         #                            #  #          #         #
#      #           ##                         #       ##############       #  ######     #         #
#      #      #    ##                         #                            #  #                    #
#      #      #    #                          #                            #  #                    #
#      #      #    #                          #                            #  #                    #
#      #      #    #                          #                   ###############                  #
#      #      #    #                          #         #           #      #  #                    #
#  ############    #                    ##########################  #      #  #                    #
#      #           #                          #         #           #      #  #                    #
#      #           #                          #         #           #      #  #                    #
#      #           #                          #         #           #      #  #                    #
#       ###################                   #         #           #         #                    #
#                   #                         # #########        #            #                    #
#                   #                                   #        #            #                    #
#                   #                                            #            #                    #
#                   #                                  #################      #                    #
#                   #                      ###############       #            #                    #
#               #   #                                            #            #                    #
#               #   #                                                         #     #              #
#               #   #                                                               #              #
#   #############   #                                                               #              #
#               #   #                                                               #              #
#         #     #   #                                                               #              #
#         #     #   #                                                               #              #
#         #     #   #                                          #########      #     #              #
#         #     #   #                                                         #                    #
#         #     #   #                                                         #                    #
#         #     #   #                                                         #                    #
#         #     #                     ###############                         #                    #
#         #     #                  ########                                   #                   ##
#         #     #              ############                                   #                    #
#   ###############                                                   #       #             #      #
#         #     #                      #                          #######     #            ##      #
#         #     #                      #                              #       #            ##      #
#         #     #                      #                              #       #            ##      #
#         #     #         #            #                              #       #            ##      #
#         #              ##            #                              #       #            ##      #
#                        ##                                           #       #            ##      #
#                        ##                                   #   #   #       #            #########
#                        ##                                   #   # ##################     ##      #
#                        ##                                   #   #   #       #             #      #
#                        ##                             #     #   #   #                     #      #
#                        ##                             #     #   #   #                     #      #
#                        ##                             #     #   #############             #      #
#                        ##########                     #     #   #   #                     #      #
#                        ##                             #     #   #   # ###########                #
#                        #       #                      #     #   #   #                            #
#                        #       #                      #     #   #                 #              #
#                        #       #                      #     #   #                 #              #
#                        ##      #                      #     #   #                 #            # #
#                        ##      #                      #         #   #################          # #
#                        ##      #                      #         #                 #            # #
#  ########              ##      #                      #         #                 #            # #
#                         #                             #         #                 #            # #
#                         #                                       #                 #          X # #
#      #                                                          ##                         #######
#      #                                             ###############                             ###
#      #                                                           #                             ###
####################################################################################################
