####################################################################################################
#                                                      #                                           #
#              ###########                             #######                                     #
#                                                ############                                      #
#                                                      #                          #                #
#   ,O                ################                 #                          #                #
# ,,,       #                  #                       #                          #                #
# ,         #                  #                       #                          #                #
# ,,,,      #                  #                       #                          #                #
#    ,,     #   #              #                       #                          #                #
#     ,     #   #                             ###############                     #                #
#     ,     #   #                     #############                               #                #
#     ,     #   #                                                                 #                #
#     ,     #   #           #                                             ############             #
#     ,,,   #   ######      #                                                #    #                #
#       ,,  #   #           #                             #                  #    #                #
#        ,  #   #           #                             #             ######### #                #
#    ,,,,,  #   #           #           #####################                #    #                #
# ,,,,      #               #                             #                  #    #                #
#,,         #               #                             #          ################              #
#,          #               #                             #                  #                     #
#,          #              ##                             #                  #       ############# #
#,          #              #                              #                # # ################### #
#,          #              #                              #                # #            ##########
#,                         #                                               # #                     #
#,                         #                                               # #                     #
#,          ######         #                                               # #                     #
#,                         #  #             ############                   # #                     #
#,                   ##############                               #          #                     #
#,                         #  #             #                     #          #                     #
#,,                        #  #    #        #                   # #          #                     #
# ,,,,,,,,                 #  #    #        #                   # #          #                     #
#  #     ,,,,,,,,,         #  #    #        #                   # #                                #
#  #             ,         #  #    #        ##                  # #                                #
#  #         ,,,,,         #  #    #         #                  # #                                #
#  #         ,                #    #     #   #                  # #                                #
#  #  ,,,,,,,,                #    #     #   #                  # #                                #
#  #  ,                       #    #     #   #                  # #                                #
#  #  ,                       #    #     #   #                  # #                                #
#  #  ,                    #####   #     #   #            #     # #                           ######
#  #  ,,,                          #     #   #            #     #                     ###########  #
#  #    , #####                    #     #   #            #                                        #
#  #    ,                          #     #   #            #                  ##################    #
#  #    ,                          #     #   #            #                                     #  #
#  #    ,,,                        #     #   #                                                  #  #
#  #      ,                        #     #                                                      #  #
#         ,                              #                                                      #  #
#         ,################              #  #                                                   #  #
#  #      ,,,,                           #  #             #########  ##################         #  #
########     ,                           #  #                                                 # #  #
#  #         ,,,,,,,,,            #         #                  #      ########                # #  #
#  #                 ,,,,,,       #         #                  #             #                # #  #
#  #                      ,       #         #                  #      ###############         # #  #
#  #                      ,,,,,,, #         #                  #             #                # #  #
#  #    #######                 , #         #                  #             #            #   # # ##
#  #                            , #         #                  #     #########            #   # #  #
#  #                            , ###########                  #             #            #   # #  #
#  #                            , #         #                  #             #            #   # #  #
#  #                            , #         #                  #             #            #   # #  #
#  #          ##########        , #                                    ########           #   # #  #
#  #                            , #                                   #      #            #   # #  #
#  #   #                    ,,,,, #                                   #      #            #   #    #
#  #   #                    ,     #              #                    #      #            #        #
#  #   #                    ,     #              #                    #      #                     #
#      #                    ,     #              #                    #      #                     #
#      #                    ,     #              #                    #      #                     #
#      #                  ,,,     #              #                    #      #                     #
#      #                  ,       #              #                    #      #                     #
#      #                  ,                      #                    #      #                     #
#      #                  ,                      #          #                #                     #
#      #                  ,                      #          #                #                     #
#      #                  ,                      #          #                               ########
#                         ,,,,                   #          #                                      #
#                            ,,,,,,,,,,,         #          #                                      #
#                                      ,         #          #                            #         #
#  #      ############                 ,,,################  #                            #         #
#  #                                     ,,,,,,,,#          #                            #         #
#  #                                            ,#       ######                          #         #
#  #                                            ,#          #           #############    #         #
#  ####### ############       # ##########      ,,,,,,,,,,,,#                    ####### ###########
#  #                          #                            ,#                                      #
#  #                          #                            ,#                                  #   #
#  #                          #                            ,#                                  #   #
#  #                          #                            ,#     ############                 #   #
#  #                          #                            ,#                                #######
#  #                          #                    ,,,,,,,,,#                                  #   #
#  #                          #                    ,                                           #   #
#  #                          #                    ,,,,,,,,,,,,,,,,,,,,,,,,,,,,,,,                 #
#   #                         #                                                  , ##############  #
#   #                         #                                                  ,               ###
#   #                         #              #                                 # ,                 #
#   #                         #              # #                               #,,                 #
#   #                         #              # #                               #,                  #
#   #                                        # #                               #,,,,,,,,,,,,,      #
#   #                                    ##### #                               #            ,      #
#   #                                        # #                               #            ,,,X   #
#   #                                        # #                    ######                         #
##  #                                        # #                                                   #
##  #             ################           # ##                                                  #
####################################################################################################
